1111111111111
10010000000C1
1000011111001
1P00111E10001
100000000C001
1111111111111
