1111111111111
10010000000C1
1000011111001
1P00111E00001
1000000000001
1111111111111