1111111111111
1001000P000C1
1000011111001
1P001110E0001
100000000C001
1111111111111
