11111111111111111111111111111111111111111111111111111
100100000000000000000000000000000C1000000000000000001
1000011111000000E0000000000000011110001000000000N0001
1000000010001000000000000000100001C100000100000000001
100000000C001000000000000000100000000C001000000000001
100100000000000000000000000000000C1000000000000000001
10000111110000000000000000000001111000100000000000001
1000000010001000000000000000100001C100000100000000001
100000000C001000000000000000100000000C001000000000001
100100000000000000000000000000000C1000000000000000001
10000111110000000000000000000001111000100000000000001
1000000010001000000000000000100001C100000100000000001
100000000C001000000000000000100000000C001000000000001
100100000000000000000000000000000C1000000000000000001
10000111110000000000000000000001111000100000000000001
1000000010001000000000000000100001C100000100000000001
100000000C001000000000000000100000000C0010000P0000001
100100000000000000000000000000000C1000000000000000001
10000111110000000000000000000001111000100000000000001
1000000010001000000000000000100001C100000100000000001
100000000C001000000000000000100000000C001000000000001
100100000000000000000000000000000C1000000000000000001
10000111110000000000000000000001111000100000000000001
1000000010001000000000000000100001C100000100000000001
100000000C001000000000000000100000000C001000000000001
11111111111111111111111111111111111111111111111111111
