1111111111111
10010000000C1
100N011111001
1000000E10001
10000P000C001
1111111111111
