1111111111111
1001000000NC1
1100000000101
1P00111E00001
110000000C001
1111111111111
