11111111111111111111111111111111111111111111111111111111
100000000000C000000C00000011
1000111111111111110111110011
1000C000000C000C000C000C0001
1000111111101111111111111001
1000C000000C000C000000C00001
1000111111101111111111111101
100000000000C000000C00000001
100011111111111111P111111101
1000C000000C000C000C000C0001
1000111111110111111111111101
1000C000000C000C000C000C0001
1000111111110111111111111101
100000000000C000000C00000001
100011111111111111E111110011
1000C000000C000C000C000C0001
1000111111101111111111111001
1000C000000C000C000000C00001
1000111111101111111111111101
100000000000C000000C00000011
1111111111111111111111111111
100000000000C000000C00000011
1000111111111111110111110011
1000C000000C000C000C000C0001
1000111111101111111111111001
1000C000000C000C000000C00001
1000111111101111111111111101
100000000000C000000C00000001
100011111111111111P111111101
1000C000000C000C000C000C0001
1000111111110111111111111101
1000C000000C000C000C000C0001
1000111111110111111111111101
100000000000C000000C00000001
100011111111111111E111110011
1000C000000C000C000C000C0001
1000111111101111111111111001
1000C000000C000C000000C00001
1000111111101111111111111101
100000000000C000000C00000011
1111111111111111111111111111
