1111111111111
1001000000NC1
1000011111001
1P00111E00001
100000000C001
1111111111111
