111111
100001
100001
100001
1PEC11
111111
