11111111111111111111
1000000E000000000001
10000010000000000001
100P00C0001000000001
1000000C000000000011
11111111111111111111
