11111111111111111111
1000000100000C000001
1000001010E00C000001
100P011111C000000001
1000000C00000C000011
11111111111111111111
