1111111111111
1000000000001
100001P100001
1000001000001
1C0000E000001
1111111111111
