111111
10CCC1
1CCPC1
1C1CC1
11E1C1
111111
