11111111111111111111
1000000C00000C000001
1000001000E00C000001
100P00C000C000000001
1000000C00000C000011
11111111111111111111
